show|show_always|around
leader|leader.vim|file
leader.vi|leader.vim|file
nvi|nvim|file
Hom|HOME|around
lual|lualine.lua|file
sou|source|around
H|HOME|around
tre|treesitter.lua|file
|material|tsc-typescript
ma|material|tsc-typescript
@mui|@mui/material|tsc-typescript
plu|plug-config.vim|file
tope|tpope|around
pre|prepend?|tsserver-typescript
createCac|createCache|tsserver-typescript
@emo|@emotion/cache|tsserver-typescript
fontSi|fontSize?|tsserver-typescript
fontWeig|fontWeight?|tsserver-typescript
font|fontSize?|tsserver-typescript
font|fontFamily?|tsserver-typescript
typ|typography?|tsserver-typescript
break|breakpoints|tsserver-typescript
comp|components?|tsserver-typescript
string|string|tsserver-typescript
spa|spacing?|tsserver-typescript
Theme|ThemeOptions|tsserver-typescript
ThemeOp|ThemeOptions|tsserver-typescript
res|responsiveFontSizes|tsserver-typescript
create|createTheme|tsserver-typescript
@mu|@mui/material|tsserver-typescript
get|getAge|tsserver-typescript
const|const|tsserver-typescript
MyA|MyApp|tsserver-typescript
|plugin-config.vim|file
conf|config|around